~@~@~..........................~@~@~
~@~@~..........................~@~@~
~@~@~........##..##............~@~@~
~@~@~........##..##............~@~@~
~@~@~%%....%%##%%##%%....%%....~@~@~
~@~@~%%....%%##%%##%%....%%....~@~@~
~@~@~##%%%%##########%%%%##%%..~@~@~
~@~@~##%%%%##########%%%%##%%..~@~@~
~@~@~########@@##@@########%%..~@~@~
~@~@~########@@##@@########%%..~@~@~
~@~@~~~~~~~##########~~~~~~%%..~@~@~
~@~@~~~~~~~##########~~~~~~%%..~@~@~
~@~@~~~##################~~~~%%~@~@~
~@~@~~~##################~~~~%%~@~@~
~@~@~######~~######~~######%%%%~@~@~
~@~@~######~~######~~######%%%%~@~@~
~@~@~####~~~~~~##~~~~~~####~~~~~@~@~
~@~@~####~~~~~~##~~~~~~####~~~~~@~@~
~@~@~%%~~~~%%%%%%%%%%~~~~%%~~%%~@~@~
~@~@~%%~~~~%%%%%%%%%%~~~~%%~~%%~@~@~
~@~@~..%%%%..........%%%%..%%..~@~@~
~@~@~..%%%%..........%%%%..%%..~@~@~
~@~@~..........................~@~@~
~@~@~...........####...........~@~@~
~@~@~...........#..#...........~@~@~
~@~@~...........#..#...........~@~@~